#############################################################
S   #           #       #           #           #           #
# # # ######### # # ### ####### ### # ####### # # ######### #
# #   #   #   # # #   # #       # # #       # #   #     #   #
# ##### # # ### ### # # # ####### # ### ##### ##### ##### ###
#       # #   #   # # #   #       #   # #   # #   #     # # #
# ####### ### ### ### ##### ##### ### # # # # # ### ### # # #
#     #         #     #   # #   #   # # # #   #       # # # #
# ### ######### ####### ### ### ### # ### ##### ####### # # #
#   #   #   #     #       #   # #   #     # #     #   # #   #
### ### # ### ##### ##### ### # # ######### # ##### # # ### #
#   # # # #   #   #     #   # # # #       #     #   #   #   #
# ### # # # ### # ### ##### # # # # ### # # ##### ##### # ###
# #   # #     # #     #     #   #   #   # #   #   # #   #   #
# # # # ##### # ####### ####### ##### ### # ### ### # ##### #
# # # #     # #   #     #   #   #   # # # # #   #   #   #   #
# # # ##### ##### # ##### # # ### ### # # ### ### # ### # ###
# # # #   #       # #     #       #   #       # # #     # # #
# # # ### ######### # ########### # # ######### # ####### # #
#   #       #     #   #     #   # # # #   #   # #   #   #   #
########### # # # ##### ### # # ### # # # # # # ### # # ### #
#   #     # # # # #   #   #   #     # # #   # #     # #     #
# # # # ### # # # ### ### ########### # ##### # ##### #######
# #   # #   # # #     #   #     # #   #   # # #     #       #
# ##### # ##### ####### ### ### # # ##### # # ##### ####### #
# #     #     # #     #   #   # # #     #   # #   # #       #
### ### ##### # # ### ### ### # # ##### ### # # # ### #######
#   #   #   # #     #   #   # # #     #   # #   #   #   #   #
# ### ### ### ######### # ### # ##### ### # ####### ### # ###
# #     #   #     #   # # #   # #   #   # # #     #     #   #
# ##### ### ##### # # # # # ### # # ### # # # # ########### #
# #   #     #   #   #   #   # #   #   #   # # #       #     #
# # # ##### # ######### ##### ####### # ### ### ##### # # ###
#   # #       #       #   #       #   # # #   # #   # # #   #
# ### ####### # # ####### ####### # ### # ### # # # # # ### #
# # #       # # #   #             # #     # # # # #   #   # #
# # ####### # # ### # ########### # ##### # # # # ##### ### #
# #   #     # #   #   #   #       #   #     # # #       #   #
# ### # ##### ### ##### # ### ####### ####### ######### # ###
# #   # #   #   #   #   #   # #     # #       #       # #   #
# # # # ### ### ### # ##### ### ### # # ####### ##### # ### #
#   # #   #       # # #   #     #     #     #   #   # # #   #
##### ### ### ##### # # # ####### ######### # ### ### ### # #
#   # # #   # #   # #   #   #     #       #   # #   #     # #
# # # # ### ### # # ####### # ##### # ######### # # ####### #
# #   #   #     #   #       # #     #     #   #   #   #     #
# ##### # ########### ######### ######### # # # ### ### #####
#   #   #     # #     #         #       #   # # #   #   #   #
### ### ### # # # ### # ########### ### ##### # # ### ##### #
# #   #   # #   # #   #       #   # #       #   #     #     #
# ### ### # ### # ########### # # ### ##### ########### ### #
#     #   #   # # #         #   # #   #     #   #         # #
# ######### # ### # # ### ####### # ### ##### ### ####### ###
# #       # # #   # #   # #       # #     #   #         #   #
# ##### # ### # ### ### # # ####### ##### ### # ######### # #
#     # #   # #   #   # # #     #     #     # # #       # # #
##### # ### # ### ### # ####### ##### ##### # # # ##### # # #
#   # # # #   # #   # #         #   #     # #   #   #   # # #
# ### # # ### # # ### ########### # ##### # ####### # ##### #
#       #       #                 #       #         #       E
#############################################################
