S #######################
#    #     #   #        #
### ### ###   ### ##### #
#   #   # # #     #     #
# ##### # # ##### # ### #
#   #   # #     # # #   #
### ### # # # ### ##### #
#     #   # # ##  #     #
# ### ##### # # ### #####
#   # #     # #     #   #
##### ### ### ##### ### #
#       #   # #     #   #
# ##### # ### # ### ### #
#   #   #   # #   #     #
### # ##### ### ##### ###
# # #   # #   #     #   #
# # ### # ### ### ### ###
# #   #   #   # #       #
### # ### ### # # #######
#   #   # #   #   #     #
# ##### # # ##### ##### #
#   # #   # # #   #     #
# ### ##### # # ### ### #
#             #     #   E
#########################
